NO textures/simonkraff/wet_sponge.xpm
WE textures/simonkraft/wet_sponge.xpm
EA textures/simonkraft/wet_sponge.xpm
SO textures/simonkraft/wet_sponge.xpm

F  1,169,10
C  155,155,10


111111111
100010001
100000001
100N00001
100000001
100000001
111111111