NO textures/simonkraff/wet_sponge.xpm
WE textures/simonkraft/wet_sponge.xpm
EA textures/simonkraft/wet_sponge.xpm
SO textures/simonkraft/wet_sponge.xpm

F  1,169,10
C  1,169,10


   111111111111111111
   1000001000000000001
   1010101010111111101
1111110100010000010001
111110101111101011101
100000101000101000001
101111101011101111111
101000001010100000101
11011111010111110101
101010001010100010101
101110101010101010101
100000101010001010001
111111101011111011101
10000010100100010001
101110101110101110111
101000100000100010101
10101111S111111101011
100010000000000010001
101010111011001111111
10000100000000001
1111111111111111111