NO /Users/khbouych/Desktop/Cub3d/assets/zlij.png
WE /Users/khbouych/Desktop/Cub3d/assets/zlij.png
EA /Users/khbouych/Desktop/Cub3d/assets/zlij.png
SO /Users/khbouych/Desktop/Cub3d/assets/zlij.png

F  1,169,10
C  155,155,10

111111111111111111111
100000000000000000001
100000000000000000001
100000000010000000001
100000000000000000001
100000001101100000001
100000000000000000001
100000000000000000001
100000001010000000001
100000000000000000001
100010000N00000010001
100000001010000000001
100000000100000000001
100010000100000010001
100000000000000000001
100000000100000000001
100010000000000001001
100000000000000000001
111111111111111111111
