NO textures/simonkraff/wet_sponge.xpm
WE textures/simonkraft/wet_sponge.xpm
EA textures/simonkraft/wet_sponge.xpm
SO textures/simonkraft/wet_sponge.xpm

F  1,169,10
C  155,155,10


1111111111111111111111111
1000000000110000000000001
1011000001110000000000001
100100000000000000W00000111111111
111111111011000001110000000000001
100000000011000001110000000001111111
11110111111111011100000010001
11110111111111011101010010001
11000000110101011100000010001
10000000000000001100000010001
10000000000000001101010010001
110000011101010111110111100111
11110111 1110101 101111010001
11111111 1111111 111111111111