NO textures/simonkraff/wet_sponge.xpm
WE textures/simonkraft/wet_sponge.xpm
EA textures/simonkraft/wet_sponge.xpm
SO textures/simonkraft/wet_sponge.xpm

F  1,169,10
C  155,155,10

111111111111111111111
100000000000000000001
100000000000000000001
100000000000000000001
100000000N00000000001
100000001111100000001
100000000000000000001
100000000000000000001
100000000110000000001
100000000000000000001
100000000000000000001
100000001110000000001
100000000100000000001
100000000100000000001
100000000100000000001
100000000110000000001
100000000000000000001
100000000000000000001
111111111111111111111
