NO textures/simonkraff/wet_sponge.xpm
WE textures/simonkraft/wet_sponge.xpm
EA textures/simonkraft/wet_sponge.xpm
SO textures/simonkraft/wet_sponge.xpm

F  1,169,10
C  0,255,10


   11111111111
   11111  1111
111100011101111
11100000000111
11000N000000011
100001111100001
110000111000011
111000011100111
1111001101111
1111000111111
11111100111111
1111111111111