NO textures/simonkraff/wet_sponge.xpm
WE textures/simonkraft/wet_sponge.xpm
EA textures/simonkraft/wet_sponge.xpm
SO textures/simonkraft/wet_sponge.xpm

F  1,169,10
C  155,155,10


111111111111111111111
101000001000000000001
101010101011111110001
100010100010000010001
111110101111101011101
100000101000101000001
101100000011101111111
101000000010100000101
101010000010111110101
101010000010100010101
101110000000001010101
100000000000001010001
111111000000001011101
100000000N00000010001
111111111111111111111